###########
#         #
######### #
#         #
# #########
#         #
######### #
# #       #
# # #######
# #       #
# ####### #
# #       #
# # #######
# #       #
# ####### #
# #       #
# # #######
#         #
###########